11111111111111111111111111
10000000000001000000000001
1P0000000C0000100000000001
10111111000000100C10000001
1000000100000010001C000001
10000C01000000100010000C01
10001001001000100011110001
1000100100100C100000010C01
1000100000100010000C010001
10001000001000000000010001
10001000001000000C000100E1
10C010000C1000000000000001
10000000000000000000000001
11111111111111111111111111
